所	戶 斤
未	一 木
无	一 尢
问	门 口
无	一 尢
论	言 仑
如	女 口
何	人 可
可	丁 口
思	田 心
议	言 义
可	丁 口
避	辵 辟
实	宀 头
千	丿 十
方	亠 勹
百	一 白
计	言 十
小	八 亅
翼	羽 異
方	亠 勹
成	戊 ㇆
千	丿 十
万	一 勹
全	人 王
全	人 王
意	音 心
无	一 尢
影	景 彡
无	一 尢
形	开 彡
都	者 邑
给	丝 合
中	口 丨
涂	水 余
炭	山 灰
生	牛 一
灵	彐 火
喷	口 贲
云	二 厶
吐	口 土
雾	雨 务
抑	手 卬
欲	谷 欠
改	己 攴
封	圭 寸
建	廴 聿
残	歹 戋
仰	人 卬
视	示 见
让	言 上
须	彡 页
有	一 丿 月
在	一 人 土
面	一 丶 囬
上	一 丨 一
事	一 口 聿
先	丿 土 儿
其	甘 一 八
乐	丿 丨 木
余	人 于 八
敢	丅 耳 攴
眉	尸 丶 目
前	丷 一 肉 刀
毫	亠 口 冂 毛
疑	匕 矢 龴 疋
不	一 丿 丨 丶
免	刀 口 丨 儿
心	丿 乚 丶 丶
扬	手 弓 丿 丿
前所未有
毫无疑问
无论如何
不可思议
不可避免
实实在在
千方百计
小心翼翼
方方面面
成千上万
全心全意
无影无踪
都给事中
涂炭生灵
喷云吐雾
欲扬先抑
不改其乐
封建残余
不敢仰视
不让须眉